============================
=            =             =
= .........  =  .........  =
= .==..===... ...===..==.  =
= ......... ... .........  =
=            .             =
=     ...............      =
= ... .=..=======..=. ...  =
= . . .=.....=.....=. . .  =
= . . .=... ... ...=. . .  =
= . . .===.  .  .===. . .  =
= . . .=...  .  ...=. . .  =
= . . .=.    .    .=. . .  =
= . . .=.    .    .=. . .  =
= ... ...         ... ...  =
=                          =
=                          =
                            

                           
..                        ..
=.                        .=
=.     .............      .=
=.     .===========.      .=
=.     .............      .=
=.           .            .=
=.           .            .=
=.           .            .=
=.......     .     ........=
=======.     .     .========
=.......     .     ........=
=.  .        .         .  .=
=.  ....................  .=
=.  .                  .  .=
=..........................=
============================