============================
=            =             =
=            =             =
=                          =
=                          =
=            =             =
=            =             =
=            =             =
=      =============       =
=      =           =       =
=      =           =       =
=      =           =       =
=      =           =       =
=      =           =       =
=      =           =       =
=                          =
=                          =
                            
                            
                            
                            
=                          =
=                          =
=       ===========        =
=                          =
=                          =
=                          =
=                          =
=                          =
=                          =
=======             ========
=                          =
=                          =
=                          =
=                          =
============================