============================
=            =             =
=            =             =
=                          =
=   ...................    =
=                          =
=            =             =
=            =             =
=      =============       =
=      =           =       =
=      =           =       =
=      =           =       =
=      =           =       =
=      =           =       =
=      =           =       =
=                          =
=                          =
                            
                            
                            
                            
=                          =
=                          =
=       ===========        =
=                          =
=                          =
=            .             =
=            .             =
=            .             =
=            .             =
=======      .      ========
=            .             =
=            .             =
=   ....................   =
=                          =
============================